11111111111115555555555555555555555551111111111
10000000000000000000000000000001000000000000001
10000000070000000000000100011100000000111100001
10011011000007001111111111111111111000000000001
10077111000000000000000000000000000000000000001
10000000000554334321230010000011111100000000001
10000000000000000000000000000000000000000000001
10000000000000000000000000000000000000000000001
10000000000000000000000000000000000000000000001
10000000000000000000000000000000000000000000001
10000000000000000000000000000000000000000000001
10000000000000000000000000000000000000000000001
10000000000000000000000000000000000000000000001
10000000000000000000000000000000000000000000001
10000000000000002222222222233334445560000000001
11110111111000000000000000000000000000000000001
00010100001000000000000007000000000000000000001
00110110001000017777000007000000001111111100001
00100010001000000000000700000000000000000000001
00111110001111111111111111111111111111111111111