15555555555566665555555555551
10000000000000000000000000001
10000002222200003333330000001
10000002222200003333330000001
10000002222200003333330000001
10000000000000000000000000001
14444444444477774444444444441